16,11,,,,,,,,,
-,-,-,-,-,-,-,-,-,-,-
-,-,-,-,-,-,-,-,-,-,-
-,-,-,-,#,#,-,-,-,-,-
-,-,-,#,#,#,#,-,-,-,-
-,-,-,#,#,#,#,-,-,-,-
-,-,-,-,#,#,-,-,-,-,-
-,-,-,-,-,-,-,-,-,-,-
-,-,-,-,-,-,-,-,-,-,-
-,-,T,T,-,-,T,T,-,-,-
-,-,T,T,-,-,T,#,#,#,#
-,-,#,T,T,-,#,#,#,#,#
-,#,#,T,-,-,T,#,#,#,#
-,#,#,-,-,-,F,-,#,#,#
#,#,#,#,-,F,-,-,-,-,-
-,#,#,#,-,-,-,-,-,-,-
-,#,#,#,-,-,-,-,-,-,-