     A    B    C    D    E    F    G    H    I    J    K
   +----+----+----+----+----+----+----+----+----+----+----+
 1 |    |    |    |    |    |    |    |    |    |    |    |
   +----+----+----+----+----+----+----+----+----+----+----+
 2 |    |    |    |    |    |    |    |    | eA |    |    |
   +----+----+----+----+----+----+----+----+----+----+----+
 3 |    |    |    |    |####|####|    |    | eb |    |    |
   +----+----+----+----+----+----+----+----+----+----+----+
 4 |    |    |    |####|####|####|####| ea |    | es |    |
   +----+----+----+----+----+----+----+----+----+----+----+
 5 | ea |    | es |####|####|####|####|    |    |    |    |
   +----+----+----+----+----+----+----+----+----+----+----+
 6 |    | ea |    |    |####|####|    |    |    |    |    |
   +----+----+----+----+----+----+----+----+----+----+----+
 7 |    |    |    |    |    |    |    |    |    |    |    |
   +----+----+----+----+----+----+----+----+----+----+----+
 8 |    |    |    |    |    |    |    |    |    |    |    |
   +----+----+----+----+----+----+----+----+----+----+----+
 9 |    |    |<  >|<  >|    |    |<  >|<  >|    |    |    |
   +----+----+----+----+----+----+----+----+----+----+----+
10 |    |    |<  >|<eb>|    |    |<  >|####|####|####|####|
   +----+----+----+----+----+----+----+----+----+----+----+
11 |    |    |####|<  >|<ea>|    |####|####|####|####|####|
   +----+----+----+----+----+----+----+----+----+----+----+
12 |    |####|####|<ea>|    |    |<  >|####|####|####|####|
   +----+----+----+----+----+----+----+----+----+----+----+
13 |    |####|####|    |    |    |{  }|    |####|####|####|
   +----+----+----+----+----+----+----+----+----+----+----+
14 |####|####|####|####|    |{  }|    |    | As | Fb |    |
   +----+----+----+----+----+----+----+----+----+----+----+
15 |    |####|####|####|    |    |    |    | Ll | Mh |    |
   +----+----+----+----+----+----+----+----+----+----+----+
16 |    |####|####|####|    |    |    |    |    |    |    |
   +----+----+----+----+----+----+----+----+----+----+----+
